##########
#       ##
# $    ###
#. ## . ##
# ####  ##
#   #   ##
#$$ #. ###
# # # $@##
# .    ###
##########
